1111111111111111111111111111111111111111111111111111111111111111
11000000000000C1001000000000000000000000000000000000000000011111
11101C1100P00C00000001101010000001111111111111111111111111111111
11101C1100000C00000001101010111111111111111111111111111100011111
11101C1100C10C00000001101010111111111111111111111111111111111111
11101C1100C10C00000001101010000000000000000000000000000000011111
11101C1100C10C00000001101011111111111111111111111111111111111111
11101C1100C10C00000001101011111111111111111111111111111111111111
11101C1100C10C00000001101010000000000000000000011000000000011111
11101C1100C10C0000000110100000000000000000000000EC11111111111111
11101C1100C10C00000001101010000000000000000000000011111111111111
11101C1100C10C00000001101011111111111111111111111111111111111111
11101C0000C10C00000001101010000111111111111111111111111111111111
1111111111111111111111111111111111111111111111111111111111111111
1111111111111111111111111111111111111111111111111111111111111111
1111111111111111111111111111111111111111111111111111111111111111
1111111111111111111111111111111111111111111111111111111111111111
1111111111111111111111111111111111111111111111111111111111111111
1111111111111111111111111111111111111111111111111111111111111111
1111111111111111111111111111111111111111111111111111111111111111
1111111111111111111111111111111111111111111111111111111111111111
1111111111111111111111111111111111111111111111111111111111111111
1111111111111111111111111111111111111111111111111111111111111111
1111111111111111111111111111111111111111111111111111111111111111
1111111111111111111111111111111111111111111111111111111111111111
1111111111111111111111111111111111111111111111111111111111111111
1111111111111111111111111111111111111111111111111111111111111111
1111111111111111111111111111111111111111111111111111111111111111
1111111111111111111111111111111111111111111111111111111111111111
1111111111111111111111111111111111111111111111111111111111111111
1111111111111111111111111111111111111111111111111111111111111111
1111111111111111111111111111111111111111111111111111111111111111
1111111111111111111111111111111111111111111111111111111111111111
1111111111111111111111111111111111111111111111111111111111111111
