111111111111111111
1C*E000C*000*0C001
10000100C000C00011
1PC0110000*000C001
111111111111111111
