111111111111111111
1C*E000C0*****C001
10000*00C000C00011
1PC0110000****C001
111111111111111111
