11111
101C1
11001
1ECP1
11111
